1 1 1 1 1 1 1 1 1 1 1 1 1 1 1 1 1 1 1 1 1 1 1 1
1 1 0 0 1 0 0 1 0 0 1 0 0 1 0 0 1 0 0 0 0 0 0 5
1 0 0 1 0 0 1 0 0 1 0 0 0 0 0 1 0 0 1 0 0 1 0 5
1 0 0 0 0 0 0 0 1 0 0 1 7 1 1 0 1 0 0 1 0 0 1 5
1 1 0 0 1 0 0 1 0 0 0 0 0 0 0 0 0 2 0 0 0 0 0 5
1 0 0 0 0 0 2 0 0 0 0 0 0 0 0 0 0 2 0 0 0 0 0 5
1 0 0 0 0 0 2 0 0 0 0 0 0 0 0 0 0 7 0 0 0 0 0 5
1 0 0 0 0 0 2 0 0 0 0 0 0 0 0 0 0 2 0 0 0 0 0 5
1 1 0 0 1 0 2 0 0 0 0 0 0 0 0 0 0 2 0 0 0 0 3 5
1 0 0 0 0 0 0 0 0 0 0 0 0 0 0 0 0 2 0 0 0 0 0 5
1 0 0 0 0 1 0 0 1 0 1 7 1 0 0 0 0 0 0 0 0 0 0 5
1 0 0 0 0 0 0 0 1 0 1 0 0 0 1 0 0 0 5 5 5 5 0 5
1 0 5 5 0 0 0 0 0 0 0 0 0 0 0 0 0 0 0 0 0 0 0 5
1 0 0 0 0 0 0 0 0 0 0 0 2 0 0 0 0 0 0 0 0 0 0 5
1 0 0 0 1 0 0 1 0 0 0 0 2 0 2 0 0 0 0 0 0 0 0 5
1 1 0 0 1 0 0 1 1 1 1 1 2 0 0 0 0 0 0 0 0 0 0 5
1 0 0 0 0 0 0 0 0 0 0 0 0 0 1 1 1 1 0 0 0 5 5 5
1 0 0 0 0 0 0 0 0 0 0 0 0 0 0 0 0 0 0 0 0 0 0 5
1 0 4 0 0 4 4 0 6 6 6 0 0 6 0 0 4 0 4 4 0 0 0 5
1 0 0 0 0 0 0 0 6 0 0 0 0 6 0 0 0 0 0 0 0 0 0 5
1 0 0 0 0 0 0 0 6 0 6 6 6 6 0 0 0 0 0 0 0 1 0 5
1 0 4 0 0 4 4 0 6 0 6 8 0 6 0 0 4 0 4 4 0 0 0 5
1 0 0 0 0 0 0 0 6 0 0 0 0 6 0 0 0 0 0 0 0 0 0 5
1 4 4 4 4 4 4 4 4 4 4 4 4 4 4 4 4 4 4 4 4 4 4 1
